##########################################################
#P                                                       #
#                                                        #
#                                                        #
#                                                        #
#                                                        #
#                                                        #
#                                                        #
#                                                        #
#                                                        #
#                                        H               #
#                                                        #
#                                                        #
#                                                        #
#                                                        #
#                                                        #
#                                                        #
#                                                        #
#                                                        #
#                                                        #
#                 H                                      #
#                                                        #
#                                                        #
#                                                        #
#                                                        #
#                                                        #
#                                                        #
#                                                        #
#                                                        #
#                                                        #
#                                                        #
#                                                        #
#                                                        #
#                                                        #
#                                                        #
#                                                        #
#                                                        #
#                                   H                    #
#                                                        #
#                                                        #
#                                                        #
#                                                        #
#                                                        #
#                                                        #
#                                                        #
#                                                        #
#                                                        #
#                                                        #
#                                                        #
#                                                        #
#                                                        #
#                                                        #
#                                                        #
#                   H                                BRON#
##########################################################